16 12
00 01 02 00 01 02 00 01 02 00 01 02 00 01 02 00 
01 02 00 01 02 00 01 02 00 01 02 00 01 02 00 01 
02 00 03 04 04 04 04 04 04 04 04 04 04 05 01 02 
00 01 06 07 07 07 07 07 07 07 07 07 07 08 02 00 
01 02 06 07 10 10 10 10 10 10 10 07 07 08 00 01 
02 00 06 08 00 01 02 00 01 02 00 06 07 08 01 02 
00 01 06 08 01 03 05 01 02 00 01 06 07 08 02 00 
01 02 06 08 02 09 11 02 00 01 02 06 07 08 00 01 
02 00 06 08 00 01 02 00 01 02 00 06 07 08 01 02 
00 01 06 07 04 04 04 05 02 00 01 09 10 11 02 00 
01 02 09 10 10 10 10 11 00 01 02 00 01 02 00 01 
02 00 01 02 00 01 02 00 01 02 00 01 02 00 01 12
15 11 01 01